YNNNNNNY
YNNNYNNY
NYNNNNNY
NNNNYNNY
NYYNYYNN
YNNYNYNY
NNNNNNNN